11111111111111111
1CEC000CC000CCC01
1001C0000000100X1
10000001E00000001
10P01000100000001
11111111111111111